200,200,50,50,128,128,128,255
1000,200,50,50,128,128,128,255
600,500,100,20,255,0,255,255
300,800,50,50,0,255,255,255
900,800,50,50,0,255,255,255
