100,100,50,50,128,128,128,255
500,100,50,50,128,128,128,255
300,250,100,20,255,0,255,255
150,400,50,50,0,255,255,255
450,400,50,50,0,255,255,255
