100,100,400,20,200,200,200,255
100,100,20,400,200,200,200,255
100,860,400,20,200,200,200,255
860,100,20,400,200,200,200,255
300,300,50,50,255,0,0,255
600,300,50,50,0,255,0,255
300,600,50,50,0,0,255,255
600,600,50,50,255,255,0,255
