50,50,400,20,200,200,200,255
50,50,20,400,200,200,200,255
50,430,400,20,200,200,200,255
430,50,20,400,200,200,200,255
150,150,50,50,255,0,0,255
300,150,50,50,0,255,0,255
150,300,50,50,0,0,255,255
300,300,50,50,255,255,0,255
