200,200,30,30,200,0,0,255
300,400,30,30,0,200,0,255
400,600,30,30,0,0,200,255
500,800,30,30,200,200,0,255
600,400,50,50,150,75,0,255
