100,100,30,30,200,0,0,255
150,200,30,30,0,200,0,255
200,300,30,30,0,0,200,255
250,400,30,30,200,200,0,255
300,200,50,50,150,75,0,255
