50,50,100,20,255,0,0,255
200,50,20,100,0,255,0,255
300,200,100,20,0,0,255,255
400,300,20,100,255,255,0,255
150,350,50,50,255,0,255,255
250,150,50,50,0,255,255,255
350,250,50,50,128,128,128,255
