100,100,100,20,255,0,0,255
400,100,20,100,0,255,0,255
600,400,100,20,0,0,255,255
800,600,20,100,255,255,0,255
300,700,50,50,255,0,255,255
500,300,50,50,0,255,255,255
700,500,50,50,128,128,128,255
